COCET 1561-1590 英語から日本語	
即座の	immediate
定期往復便	shuttle
宇宙飛行士	astronaut
天文学	astronomy
心理学	psychology
文献、文学	literature
信条、理念	philosophy
犠牲者、被害者	victim
評価	assessment
視界、視力	sight
視覚、視力	vision
境界、限界	boundary
影、人影	shadow
収入	income
支出	expenditure
文字、性格	character
奪う	rob
見分ける、識別する	distinguish
注射する	inject
判断する、審判	judge
潤滑させる	lubricate
参照する	refer
引用する	cite
分離する	isolate
捨てる	abandon
雇う	employ
興奮させる	excite
ふるまう	behave
却下する、拒絶する	reject
崩壊する	decay
