COCET 1591-1620 日本語から英語
意味する、暗示する	imply
卒業する、卒業生	graduate
学部生	undergraduate
賃金	wage
見通し	prospect
議長、司会者	chairman
雨林	rainforest
電子レンジ	microwave
編成、構成	formation
態度、心構え	attitude
熱、熱狂	fever
食欲	appetite
燃焼	combustion
徴候	symptom
膜	membrance
試作品	prototype
無作為の	random
内部の、内面的な	internal
外部の	external
奇妙な、奇数の	odd
安定した	stable
幅広い	widesperead
最高の、最大の	maximum
最小の	minimum
わずかな、かすかな	slight
激しい、暴力的な	violent
編集する	edit
訴える、訴え	appeal
引き起こす	pose
とらえる、捕獲	capture