COCET 1561-1590 日本語から英語	
immediate	即座の
shuttle	定期往復便
astronaut	宇宙飛行士
astronomy	天文学
psychology	心理学
literature	文献
philosophy	信条
victim	犠牲者
assessment	評価
sight	視界
boundary	境界
shadow	影
income	収入
expenditure	支出
character	文字
rob	奪う
distinguish	見分ける
inject	注射する
judge	判断する
lubricate	潤滑させる
refer	参照する
cite	引用する
isolate	分離する
abandon	捨てる
employ	雇う
excite	興奮させる
behave	ふるまう
reject	却下する
decay	崩壊する
