COCET 1410--1440 英語から日本語
mention	について言う
delay	遅らせる
ignore	無視する
recommend	薦める
deliver	配達する
arise	起こる
contribute	貢献する
respect	尊敬する
insult	侮辱する
violate	破る
puzzle	困惑させる
log	丸太
vessel	管
bowl	鉢
deck	甲板
cabin	小屋
anchor	錨
stock	株式
collapse	崩壊
thread	糸
needle	針
impression	印象
path	通り道
branch	支店
altogether	全体で
clockwise	時計回りに
upright	垂直に
respectively	それぞれ
regardless	かかわらず
gentle	優しい