COCET 1591-1620 英語から日本語	
imply	意味する
graduate	卒業する
undergraduate	学部生
wage	資金
prospect	見通し
chairman	議長
rainforest	雨林
microwave	電子レンジ
formation	編成
atitude	態度
fever	熱
appetite	食欲
combustion	燃焼
symptom	徴候
membrance	膜
prototype	試作品
random	無作為の
internal	内部の
external	外部の
odd	奇妙な
stable	安定した
widesperead	幅広い
maximum	最高の
minimum	最小の
slight	わずかな
violent	激しい
edit	編集する
appeal	訴える
pose	引き起こす
capture	とらえる